[nivel3]

origen= terrenogen.png

mapa=$$$$$$..$$$$$$$$$$$$$.........................$$$$$$$$$$$$&&&..............$$$$$$$$$$$$$$$$$......................................$$$$$$$$$$$$$$$$$$$$$$$$$$$$$$$....................................................................................................................................................$$$$$$$$$$$$$$$$$$.........$$$$$$$$$$$$$$$$$$$$$...................................................................................................................................................................................................$$$................................................................................................................................................................................................................................$$$$$$$$$$$$$$$$$$$.......................................................$$$$$$$$$$$$........................................................$$$$$$$$$$$$$$$$$$$$$$$$$.........................................................................
	 ......$$.............&&&&$$$$$$$$$$$$$$$$$$$$$..............................................&&&&&&&&&&&&&$$$$$$$.................................................................................................................................&&&&&&&&&&&&&&&&&&&&&&&&&&.......$$$$$$$$$$$$$$$$$$$$$$$$$$$$$$................................................................................................................................................................$$$$$$$$$$$$$$$$&&&&&$$$.....................................................$$$$$$$$$$$$$$$...................................$$$$$$$$$$$.................................$$$$$$$$$$$$$$$$$$$$$$$$..........$$$$$$$$$$$$$$$$$$$$$$$$$$$$$$$$$$$$$$$$$$$$$$$$$$$$$$$$$$$$$$$$...............................................................................................$$$$$$$$$$$$$$$$$$$$$$$$$$$$$$$$$$$$$$............................................................................................$$$$$$$$$$$$$$$..........$$$$$$$$$$..........................
	 .................................................................................................$$$$$$$$$$$$....................................................$$$$$$$$$$$$$$$$$$$&&&&&&&&&&&&&..........$$$$$$$$$$$$$$$$$$$$$$$$$$&&&&&&&&&&&&&.......................................................................................................................$$$$$$$$$$$$$$$$$$$$$$$$$$$$$$$$$$$$............................................$$$$$$$$$$$$$$$$$$$$$$$$$........................$$$$$$$$$$$$$$$$$$$$$$$$$..................................................................................................................................................................................................................................................................................................................................................................................................................$$$$$$$$$$$$$$$$$$$$$$...................................................$$$$$$$$$$$$.................
	 ..........................................................................................................$$$$$$$$$$........................................................................................................................................................................................................................................................................................$$$$$$$$$$$$$$$$$$$$$$$$$$$$$$$$$$$$$$$$$$$$$$$$$$$$$$$$$&&&&&&&&&&&&..................................................$$$$$$$$$$$$$$$$$$$$$..............................$$$$$$$$$$$$$$$$$$$$$$$$..........$$$$$$$$$$$$$$$$$$$$$$$$$$$$$$$$$$.....................................................................................................................$$$$$$$$$$$$$$$$&&&&$$$$$$$$$$$.......................................................................................................................................................................................................................$$$$$$$$$$$$$$$$$$$$$.
	 ...............................................................................................................$$$$$$$$$$.....................................................................................................................................................................&&&&&&&.....................................................................................................................................................................................................................................................................................................................................................................................................................................................................................................................................................................................................................................................................................................................................................f
	 ...$$$$$$$$$$.........................................................................................................$$$$$$$$$$$$$$$$$$$$$$$$.................&....................................................................................................................................................................................................................................................................................................................................................................................................................................................................................................................................................................................................................................................................................................................................................................&&&&&&&&&&&&&.........................................................................................................f
	 ...............................................................................................................................&&&&&&&&&&&&.....................&..............................................................................................................................................................................................&&&&&&&&&&&&&..............................................................................................................................................................................................................................................................................................................................................................................................................................................................................................................................................................................................................................................................................f
	 ................................................&&&&&&&&&&&&&&..................................................................................................&....................$$$$$$$$$$$$$$$$$$$$...............&...&..................................................................................................................................................................................................................................................................................................................................................................................................................$$$$$$$$$$$$$$$$$................&&&&&&&&&&&&&............$$$$$$$$$$$$$$$$$$$$$$$$..................................................................................................................................................................................................................................................................................................$$$$$$$$...............f
	 ................................................................................................................................................................&..............................................................................................................................$$$$$$$$$$$$$$$$$$$$&&&&&.....................................................................................................................$$$$$$$$$$$$....................................................................................................................................$$$$$$$$$$$$$..................................................................................................................................................................................................................................................................................$$$$$$$$$$$$$$$$$$$$$$$$$$$$$$$$$$$$..........................................................................................................................f
	 ...$$$$$$$$$$.............................................................................................................................................................................................................................................................................................................................................................................................................................................................................................................................................................................................................................................................................................................................................................................................................................................................................................................................................................................................................................................f
	 ...............................................................................................................................................................&..............................................................................................................................................................................................................................................................................................................................................................................................................................................................&&&&&&&&...........................................................................................&&&&................................................................................................$$$$$$$$$$$$$$$$$$$...............................................................................................................$$$$$$$$$$$$$$$$$$$$$$$............................................................f
	 ..........................................................................................................................................................................................................................................................................................................................................................................................................................................................................................................................................................................................................................................................................................................................................................................................................................................................................................................................................................................................................................................................f
	 ..........................................................................................................................................................................................................................................................................................................................................................................................................................................................................................................................................................................................................................................................................................................................................................................................................................................................................................................................................................................................................................................................f
	 ...$$$$$$$$$$.................................................................................................$$$$$$$$$$............................................................................................................................................................................................................................................................................$$$$$$$$$$$$$$$$$$$$$$$$$$$$$$$$$$$$$$$$$$$$$$$$$$$$$$$$$$$$$$$$$$$$$$$$$$$$$$$$&&&&&&&&$$$$$$$$$$$$$$$$$$$$$$$$$$$$$$$$$$$$$$$$$$$$$$$$$$$$$$$$$$$$$$$$$$.................................$$$$$$$$$$$$$$$$$.........................................................................................................................................................................................................................................................................................................................................................................................................................$$$$$$$$$$$$$$$$$.
	 ..........................................................................................................$$$$$$$$$$...........................................................................$$$$$$$$$$$$$$$$$$$$$$$$$$$$$$$..................................................................................................................................................$$$$$$$$$$$$$$$$$$$$$$.........................................................................................................................................................$$$$$$$$$$$$$$$$$...................................$$$$$$$$$$$$$$$$$$$$$$$$$$$$$$$$$$$$$$$$$$&&&&&&&&&&&&.......................................................................................................................................................................................................................................................................................................................................................$$$$$$$$$$$$...............
	 ...............................$$$$$$$$$$&&&.................$$$$$$$$$$$$$$$.....................$$$$$$$$$$$$$.........................................................................................................$$$$$$$$$$$$$$$$.........$$$$$$$$$$$$$$$$$$$$$$$$$..................$$$$$$$$$$$$$$$&&&&&&&&&................................$$$$$$$$$$$$$$$$$$$$$$$$$$$$................................................................................................................................................................................................................................................................................................................................................................................................................................................................................$$$$$$$$$$$$$$$$$$$$$$$$$$$$$$$$$$$$$$$$$$$$...........................................................................................................$$$$$$$$$$$$$$.......................
	 $$$$$$$$$$$$$$$$$$$$$$$$$$$$$$$$.....................$$$$$$$$$$..........................$$$$$$$$$$$$$$$$$$$$$$$$$....................$$$$$$$$$$$$$$$$$$$$$$$$$$$$$$.....$$$$$$$$$$$$$$$$$$$$..................................................................................&&&&&&&&&......................$$$$$$$$$$$$$$$$.........&&&&&&&&&$$$$$$$$$$$$$$$.............................................................................................................................................................................................................................................................................................................................................................................................................$$$$$$$$$$$$$$$$$$$$$$$$$$$$$$$$$$$$$$$$$$$$$$$$$$$$$$$$$$$$$$$$$$$$$$$$$$$$$$$$$$$$$......................................$$$$$$$$$$$$$$$$$$$&&&&&&.............$$$$$$$$$$$$$$$$$$.................&&&&&&&&&&&&&&.............................................................
	 



[.]
nombre=transparente

ux=0

uy=0


[$]
nombre=muro

ux=0

uy=0


[&]
nombre=cuchilla

ux=0

uy=0


[#]
nombre=obstaculo

ux=0

uy=0